...##.
..##.#.##.#
.##..###..#
##.......##
#...@..#..#
###..###..#
..#..#....#
.#####.#.##
.#.....###
.#.....##
.####.##