##.##.
..##.#.##.#
.##..###..#
##...#...##
#...@..#..#
###..###..#
..#..#....#
.##....#.##
.#.....###
.##....##
.####.##